000000000000000000000000000000000000000000000
000000000000000000000000000000000000000000000
000000000000000000000000000000000000000000000
000000000000000000000000000000000000000000000
000000000000000000000000000000000000000000000
000000000000000000000000000000000000000000000
000000000000000000000000000000000000000000000
000000000000000000000000000000000000000000000
111111111111111111111100001111111111100000000
111111111111111111111111111111111111111111111
000000000003112655221111111112226252111111111
000000000022211622565265625622656552500000011
000000000252621156626226522632656266500000000
000000000265521125262653656225626625000000000
000000000566256115222226555526226220000000000
000000000656662211555625222526635600000000000
000000000052256661132255625226565620000000000
000000000005525231111141112625555226000000000
000000000006565211111323111156265530000000000
000000000065565611266265551111665665000000000
000000000262266611262565625611165200000000000
000000000526662511565255566651115500000000000
000000000226222211262262255662111100000000000
000000000666265112662626526226211111100000000
000000000262265116555655625252521111111111111
000000000555222446656236662566665500111111111
000000000226221132265656525565526660000111111
000000000626251166265626222265666362000000000
000000000065611266656262522655562652500000000
000000000011116665252523555256626265200000000
111111111116626556526663366225625525600000000
000000000022666226525522556526265662200000000
000000000066626555555526266556626222600000000
000000000006662232566226556565256653500000000
000000000055655555255562236522266525200000000
000000000523562525655626652236226635200000000
000000000026656366565526562652222626500000000
000000000005556552525000000066556260000000000
000000000000000000000000000000000000000000000
000000000000000000000000000000000000000000000
000000000000000000000000000000000000000000000
000000000000000000000000000000000000000000000
000000000000000000000000000000000000000000000
000000000000000000000000000000000000000000000
000000000000000000000000000000000000000000000
