000000000000000000000000000000000000000000000
000000000000000000000000000000000000000000000
000000000000000000000000000000000000000000000
000000000000000000000000000000000000000000000
000000000000000000000000000000000000000000000
000000000000000000000000000000000000000000000
000000000000000000000000000000000000000000000
000000000000000000000000000000000000000000000
111111111111111111111100001111111111100000000
111111111111111111111111111111111111111111111
000000000003116266521111111115565252111111111
000000000062611556265526556265556566600000011
000000000522621126526525552535522556500000000
000000000566521125225653552222652525000000000
000000000526255116525265255662522220000000000
000000000526656611666566526656632500000000000
000000000056556261135652522665622650000000000
000000000002522631111141116622522266000000000
000000000006622211111353111166665230000000000
000000000056566511525262261111225655000000000
000000000225622211666666625611125500000000000
000000000255525211562665256661115600000000000
000000000665552211565622665622111100000000000
000000000252556115626222622622511111100000000
000000000252526116655555526555251111111111111
000000000622556445225236262655665500111111111
000000000555561135622525565255526560000111111
000000000626551156256262665566665365000000000
000000000022211265655566265622656225600000000
000000000011116225625523522565666255200000000
111111111116525266562623325625652622600000000
000000000056222522552552226265656656200000000
000000000026566526525622252655255222500000000
000000000005662235225226552562226563500000000
000000000022656626556665235562526652200000000
000000000553625655652522266536226635600000000
000000000022525326562552566256222625600000000
000000000005626526226000000062556260000000000
000000000000000000000000000000000000000000000
000000000000000000000000000000000000000000000
000000000000000000000000000000000000000000000
000000000000000000000000000000000000000000000
000000000000000000000000000000000000000000000
000000000000000000000000000000000000000000000
000000000000000000000000000000000000000000000
