000000000000000000000000000000000000000000000
000000000000000000000000000000000000000000000
000000000000000000000000000000000000000000000
000000000000000000000000000000000000000000000
000000000000000000000000000000000000000000000
000000000000000000000000000000000000000000000
000000000000000000000000000000000000000000000
000000000000000000000000000000000000000000000
111111111111111111111100001111111111100000000
111111111111111111111111111111111111111111111
000000000003115225221111111112666225111111111
000000000026611552256252552626622626200000011
000000000255521155525656652632666265200000000
000000000522651122556263252656626256000000000
000000000565522115626565562556665550000000000
000000000556525211256626666656236200000000000
000000000052556551135666622552565220000000000
000000000006225531111141116655526252000000000
000000000002552511111363111165656230000000000
000000000062252611562622521111565665000000000
000000000656525611665222626211162600000000000
000000000252225611226656562221115200000000000
000000000556526211256526225622111100000000000
000000000666256112266556526525511111100000000
000000000626565112565562256522561111111111111
000000000525562445262532562566566600111111111
000000000222651135555662552655525560000111111
000000000222621122256665622666262355000000000
000000000052211626655652225665625552500000000
000000000011115266626663666625552665200000000
111111111112656555622253326556256556600000000
000000000022226252262656266265662252600000000
000000000065252226222662625656652266200000000
000000000006256535256262525262666663600000000
000000000065522665256566236225526265200000000
000000000223226555552262622536652636200000000
000000000056222365665666662665562262200000000
000000000006652656256000000065562550000000000
000000000000000000000000000000000000000000000
000000000000000000000000000000000000000000000
000000000000000000000000000000000000000000000
000000000000000000000000000000000000000000000
000000000000000000000000000000000000000000000
000000000000000000000000000000000000000000000
000000000000000000000000000000000000000000000
