000000000000000000000000000000000000000000000
000000000000000000000000000000000000000000000
000000000000000000000000000000000000000000000
000000000000000000000000000000000000000000000
000000000000000000000000000000000000000000000
000000000000000000000000000000000000000000000
000000000000000000000000000000000000000000000
000000000000000000000000000000000000000000000
111111111111111111111100001111111111100000000
111111111111111111111111111111111111111111111
000000000003115225651111111116255252111111111
000000000026211625265652256226626566200000011
000000000662551156626255522632266555200000000
000000000652661156566523262255566665000000000
000000000566666116252655556552666620000000000
000000000656665211262555265525535600000000000
000000000025266651135622225662565620000000000
000000000002565531111141116656562562000000000
000000000006266611111353111126625230000000000
000000000066622611226526651111255555000000000
000000000552652511225525666211162500000000000
000000000226225211266265522551112200000000000
000000000556265611225656666555111100000000000
000000000565256115222562552662611111100000000
000000000562562112225522226552251111111111111
000000000662262446622636256226256600111111111
000000000565251135522525655525526250000111111
000000000252621155562525662225622365000000000
000000000065611222265255665262566565500000000
000000000011112255525653662656525625200000000
111111111116225655565523322665252666600000000
000000000055626662625626656252265622500000000
000000000062556562226522652522226655600000000
000000000005226535622525525556255523500000000
000000000055526266222252532525625526500000000
000000000263625665256666556532556636200000000
000000000066622352265222256266566256200000000
000000000005225666662000000062655660000000000
000000000000000000000000000000000000000000000
000000000000000000000000000000000000000000000
000000000000000000000000000000000000000000000
000000000000000000000000000000000000000000000
000000000000000000000000000000000000000000000
000000000000000000000000000000000000000000000
000000000000000000000000000000000000000000000
