000000000000000000000000000000000000000000000
000000000000000000000000000000000000000000000
000000000000000000000000000000000000000000000
000000000000000000000000000000000000000000000
000000000000000000000000000000000000000000000
000000000000000000000000000000000000000000000
000000000000000000000000000000000000000000000
000000000000000000000000000000000000000000000
111111111111111111111100001111111111100000000
111111111111111111111111111111111111111111111
000000000003115655621111111112552655111111111
000000000025511666256262622522565626500000011
000000000562551162555665225535655226600000000
000000000266621166666623656255555656000000000
000000000655565112522555565262626560000000000
000000000522266611555256222255636600000000000
000000000065565651132625555622552260000000000
000000000005622631111141115525256255000000000
000000000006565511111323111125252530000000000
000000000055552211225656621111666522000000000
000000000625662511626526265511126500000000000
000000000556252611225266225661112600000000000
000000000555666211662552626622111100000000000
000000000266562112555525552652611111100000000
000000000252555116665252666526561111111111111
000000000525666446665232655262526200111111111
000000000556221136662552565522655650000111111
000000000625261122256626655566662356000000000
000000000055511555662565226562656566600000000
000000000011115562552553522525625522600000000
111111111116662255565553352626552656500000000
000000000056566526665662556565552652600000000
000000000062662662556625256265552566600000000
000000000002266235566555622662656253200000000
000000000025226225525262632565625665200000000
000000000223656562626265626235255536500000000
000000000062222366562565522225555652200000000
000000000002225566525000000022622650000000000
000000000000000000000000000000000000000000000
000000000000000000000000000000000000000000000
000000000000000000000000000000000000000000000
000000000000000000000000000000000000000000000
000000000000000000000000000000000000000000000
000000000000000000000000000000000000000000000
000000000000000000000000000000000000000000000
