000000000000000000000000000000000000000000000
000000000000000000000000000000000000000000000
000000000000000000000000000000000000000000000
000000000000000000000000000000000000000000000
000000000000000000000000000000000000000000000
000000000000000000000000000000000000000000000
000000000000000000000000000000000000000000000
000000000000000000000000000000000000000000000
111111111111111111111100001111111111100000000
111111111111111111111111111111111111111111111
000000000003116265621111111112566656111111111
000000000062511555225262656655622266200000011
000000000665661155665226565232566652200000000
000000000252621125565553526225252622000000000
000000000655226116626656666256526220000000000
000000000666552211622255255625236600000000000
000000000056655651135655665666562260000000000
000000000006225631111141112565662566000000000
000000000006552511111323111166552630000000000
000000000062626611262562521111265566000000000
000000000552522511655266222511152600000000000
000000000555666511552562525651112500000000000
000000000566625211222665225552111100000000000
000000000626226115626225266625511111100000000
000000000266265112525622666256261111111111111
000000000625666442655636262556626500111111111
000000000555561135222565562226525260000111111
000000000265551126225555556226625365000000000
000000000056611522656626565526625656200000000
000000000011116226262253256526655656200000000
111111111116225226225563365566625226500000000
000000000026662266252256626262622262600000000
000000000066255662555565665652665666600000000
000000000005525235655522562266652263500000000
000000000065265656555555632565265625200000000
000000000663522652565255552632626235500000000
000000000062665366222662666522626552200000000
000000000005222256656000000055522220000000000
000000000000000000000000000000000000000000000
000000000000000000000000000000000000000000000
000000000000000000000000000000000000000000000
000000000000000000000000000000000000000000000
000000000000000000000000000000000000000000000
000000000000000000000000000000000000000000000
000000000000000000000000000000000000000000000
