000000000000000000000000000000000000000000000
000000000000000000000000000000000000000000000
000000000000000000000000000000000000000000000
000000000000000000000000000000000000000000000
000000000000000000000000000000000000000000000
000000000000000000000000000000000000000000000
000000000000000000000000000000000000000000000
000000000000000000000000000000000000000000000
111111111111111111111100001111111111100000000
111111111111111111111111111111111111111111111
000000000003112666221111111115255262111111111
000000000025211252226226566255262655600000011
000000000565251122255562625232225266200000000
000000000656551162665553265662526655000000000
000000000626625115222262262625626520000000000
000000000226556511256655525555536600000000000
000000000055656651135225265565555250000000000
000000000006656631111141116556666225000000000
000000000005665511111363111125565230000000000
000000000022265511565262221111565256000000000
000000000225522511225262666211162600000000000
000000000226225611262222265251112600000000000
000000000525226511666556256625111100000000000
000000000265256115625255562522611111100000000
000000000562566115566562552662551111111111111
000000000562552446552235622222262200111111111
000000000262521136526665266555565560000111111
000000000255551122255652552222666362000000000
000000000062511626256252262262222266200000000
000000000011112655626623522656255655600000000
111111111115525552252563355525566666600000000
000000000062226622555622555625255256500000000
000000000025225655556522562225562562200000000
000000000002652632652666665252265223600000000
000000000066555662552222236556556265500000000
000000000263655562252265626236255636200000000
000000000066266326265656262625222656500000000
000000000006256565256000000066252250000000000
000000000000000000000000000000000000000000000
000000000000000000000000000000000000000000000
000000000000000000000000000000000000000000000
000000000000000000000000000000000000000000000
000000000000000000000000000000000000000000000
000000000000000000000000000000000000000000000
000000000000000000000000000000000000000000000
