000000000000000000000000000000000000000000000
000000000000000000000000000000000000000000000
000000000000000000000000000000000000000000000
000000000000000000000000000000000000000000000
000000000000000000000000000000000000000000000
000000000000000000000000000000000000000000000
000000000000000000000000000000000000000000000
000000000000000000000000000000000000000000000
111111111111111111111100001111111111100000000
111111111111111111111111111111111111111111111
000000000003112626561111111112566552111111111
000000000052611252225562526522656665200000011
000000000652661126522252556536565222600000000
000000000655521162226653626262565266000000000
000000000562265112526525266525565620000000000
000000000522252211555266625256632500000000000
000000000025225521132555656526265620000000000
000000000006565531111141112252665526000000000
000000000006625211111323111125255230000000000
000000000026666511266626261111626222000000000
000000000525526511562652662211162500000000000
000000000256255511552656565551112200000000000
000000000562266511565222622626111100000000000
000000000552556112255565625625611111100000000
000000000222626116256655222526661111111111111
000000000556652446262236522255522500111111111
000000000655651136666655262562652620000111111
000000000266561126626626666256255362000000000
000000000052611526256552626266555622200000000
000000000011112565526663666565265255600000000
111111111115226566666523365562525262500000000
000000000056262555556556256225556565200000000
000000000025625225256266656552662552600000000
000000000002562636225256622622522563500000000
000000000052266256226565636225662526200000000
000000000623525662556552266636622632600000000
000000000025256322522225566252256225500000000
000000000006262226625000000066525620000000000
000000000000000000000000000000000000000000000
000000000000000000000000000000000000000000000
000000000000000000000000000000000000000000000
000000000000000000000000000000000000000000000
000000000000000000000000000000000000000000000
000000000000000000000000000000000000000000000
000000000000000000000000000000000000000000000
