000000000000000000000000000000000000000000000
000000000000000000000000000000000000000000000
000000000000000000000000000000000000000000000
000000000000000000000000000000000000000000000
000000000000000000000000000000000000000000000
000000000000000000000000000000000000000000000
000000000000000000000000000000000000000000000
000000000000000000000000000000000000000000000
111111111111111111111100001111111111100000000
111111111111111111111111111111111111111111111
000000000003115226261111111116565262111111111
000000000066211226622526562562656556600000011
000000000665261166225555556236262526500000000
000000000526221155655553255265555666000000000
000000000525666115256652655266566560000000000
000000000262666511655526665525536500000000000
000000000055252261135565265255262520000000000
000000000005265631111141116222562256000000000
000000000005225511111353111165652630000000000
000000000026222511562222651111565222000000000
000000000255525511666226552611122500000000000
000000000266226611266266552661115200000000000
000000000222226611565226662652111100000000000
000000000265222116562226656226611111100000000
000000000252622115525252522655621111111111111
000000000556652445556236565256666500111111111
000000000566261136622266525666625620000111111
000000000556621152256256266522665356000000000
000000000062511225556662625566625652200000000
000000000011115265225553655656225262200000000
111111111112562656256523325252226656500000000
000000000066552566526265226662562222200000000
000000000022622655652666226525655626200000000
000000000005525532556562256526666253600000000
000000000022625522262225235622262562200000000
000000000653652652626256252232555636500000000
000000000055626362252552222525666626600000000
000000000005655662252000000025652660000000000
000000000000000000000000000000000000000000000
000000000000000000000000000000000000000000000
000000000000000000000000000000000000000000000
000000000000000000000000000000000000000000000
000000000000000000000000000000000000000000000
000000000000000000000000000000000000000000000
000000000000000000000000000000000000000000000
