000000000000000000000000000000000000000000000
000000000000000000000000000000000000000000000
000000000000000000000000000000000000000000000
000000000000000000000000000000000000000000000
000000000000000000000000000000000000000000000
000000000000000000000000000000000000000000000
000000000000000000000000000000000000000000000
000000000000000000000000000000000000000000000
111111111111111111111100001111111111100000000
111111111111111111111111111111111111111111111
000000000003112522621111111112662625111111111
000000000065211252526555256652526225600000011
000000000565261126562665262632226555500000000
000000000656521155256263256522522622000000000
000000000665566116665225256655656550000000000
000000000566565611256665525652535500000000000
000000000052656561132622226626266520000000000
000000000002526531111141116555666262000000000
000000000002666611111323111126262230000000000
000000000056552511622556251111652252000000000
000000000555555211255255652511125500000000000
000000000526626211226266252251115600000000000
000000000252265611552222662666111100000000000
000000000565226115626666255265611111100000000
000000000226655112525255652255661111111111111
000000000566566442625232565526525600111111111
000000000222521132266525566666655260000111111
000000000252261122562625656526552352000000000
000000000026611625222665662622552666500000000
000000000011112526626563652625265665500000000
111111111116656225256523356225566652500000000
000000000025665666665622222656525522500000000
000000000062625565622662655566655626200000000
000000000006652635565656662225565223200000000
000000000025665652625252536565555525200000000
000000000623262526662552666636266632500000000
000000000052262362666255622252656625600000000
000000000005556622626000000062252650000000000
000000000000000000000000000000000000000000000
000000000000000000000000000000000000000000000
000000000000000000000000000000000000000000000
000000000000000000000000000000000000000000000
000000000000000000000000000000000000000000000
000000000000000000000000000000000000000000000
000000000000000000000000000000000000000000000
