000000000000000000000000000000000000000000000
000000000000000000000000000000000000000000000
000000000000000000000000000000000000000000000
000000000000000000000000000000000000000000000
000000000000000000000000000000000000000000000
000000000000000000000000000000000000000000000
000000000000000000000000000000000000000000000
000000000000000000000000000000000000000000000
111111111111111111111100001111111111100000000
111111111111111111111111111111111111111111111
000000000003116526251111111112552666111111111
000000000026511552252225225626556666600000011
000000000625221162562652265635222262200000000
000000000522651126626523555522662666000000000
000000000666666112562566552252252650000000000
000000000555662611252256222656232600000000000
000000000066626251136656562526522250000000000
000000000006565631111141116222222626000000000
000000000005622611111353111152522530000000000
000000000025655511655226651111655666000000000
000000000656525611266622222611122600000000000
000000000556666611522526625261115500000000000
000000000222252511656555255526111100000000000
000000000265222112522625566626211111100000000
000000000552525115526666566252521111111111111
000000000665265445562632566226226600111111111
000000000265521135556565565256622550000111111
000000000665551156526552252525662366000000000
000000000022611552225552622222252225200000000
000000000011115525662253266252222552600000000
111111111112655655526653325252266252600000000
000000000055626222555625226552662222600000000
000000000055526522255565265652655225200000000
000000000005266635555266562225626663200000000
000000000062522556562565636555526265500000000
000000000653652625552262652536255235600000000
000000000055226355526666526262222262200000000
000000000006255665662000000022255250000000000
000000000000000000000000000000000000000000000
000000000000000000000000000000000000000000000
000000000000000000000000000000000000000000000
000000000000000000000000000000000000000000000
000000000000000000000000000000000000000000000
000000000000000000000000000000000000000000000
000000000000000000000000000000000000000000000
