000000000000000000000000000000000000000000000
000000000000000000000000000000000000000000000
000000000000000000000000000000000000000000000
000000000000000000000000000000000000000000000
000000000000000000000000000000000000000000000
000000000000000000000000000000000000000000000
000000000000000000000000000000000000000000000
000000000000000000000000000000000000000000000
111111111111111111111100001111111111100000000
111111111111111111111111111111111111111111111
000000000003112252551111111112222262111111111
000000000055511256562526552556622656500000011
000000000665221125265555525536662566500000000
000000000225261125525553222622556266000000000
000000000562556116256652662552562660000000000
000000000525565211655652525556536600000000000
000000000022266551136222526255266520000000000
000000000002225631111141116265565652000000000
000000000005556511111323111122626630000000000
000000000052222611525626651111565522000000000
000000000556565211625552625611122500000000000
000000000665666611266222225561115500000000000
000000000622226511526566662222111100000000000
000000000565256112665226262562611111100000000
000000000622652116525666662625251111111111111
000000000226662442662532522555226200111111111
000000000562221136656562262265666650000111111
000000000266621165662225562666662356000000000
000000000066611525662666552256666225600000000
000000000011115562565553262565222555600000000
111111111112625265265623365255665625600000000
000000000066222526522226552226266665500000000
000000000025265222666265565626555556200000000
000000000002562632255656562255266563200000000
000000000065626526222255532655226255200000000
000000000553652656556252566632256635600000000
000000000055626355526262526656565225500000000
000000000005655555625000000065256250000000000
000000000000000000000000000000000000000000000
000000000000000000000000000000000000000000000
000000000000000000000000000000000000000000000
000000000000000000000000000000000000000000000
000000000000000000000000000000000000000000000
000000000000000000000000000000000000000000000
000000000000000000000000000000000000000000000
