000000000000000000000000000000000000000000000
000000000000000000000000000000000000000000000
000000000000000000000000000000000000000000000
000000000000000000000000000000000000000000000
000000000000000000000000000000000000000000000
000000000000000000000000000000000000000000000
000000000000000000000000000000000000000000000
000000000000000000000000000000000000000000000
111111111111111111111100001111111111100000000
111111111111111111111111111111111111111111111
000000000003112665521111111116525665111111111
000000000026611255252556226626565555500000011
000000000225661122566522625236656626200000000
000000000222551166622653265222266625000000000
000000000655662112656562662522526250000000000
000000000525555611225625662565632200000000000
000000000022565561135566552262626650000000000
000000000006626531111141116656662252000000000
000000000002552611111353111156566530000000000
000000000026255211555562261111526652000000000
000000000656256611565252626511156500000000000
000000000225655611652255265561112600000000000
000000000266525611665522662256111100000000000
000000000526665112225666526255611111100000000
000000000556525112652252566626551111111111111
000000000562255442662635255656625200111111111
000000000225621135566662226552262560000111111
000000000552251156655665225625252366000000000
000000000025611262565262626626226555600000000
000000000011116626266653555655626252200000000
111111111112655656262253322252562266500000000
000000000026222652562656526252222665200000000
000000000055552625565526525266622666600000000
000000000005666532526626265226522523200000000
000000000056666555625225635522225265500000000
000000000253256625622625225532662635500000000
000000000066226325566656655526226622200000000
000000000002655625656000000066555550000000000
000000000000000000000000000000000000000000000
000000000000000000000000000000000000000000000
000000000000000000000000000000000000000000000
000000000000000000000000000000000000000000000
000000000000000000000000000000000000000000000
000000000000000000000000000000000000000000000
000000000000000000000000000000000000000000000
