000000000000000000000000000000000000000000000
000000000000000000000000000000000000000000000
000000000000000000000000000000000000000000000
000000000000000000000000000000000000000000000
000000000000000000000000000000000000000000000
000000000000000000000000000000000000000000000
000000000000000000000000000000000000000000000
000000000000000000000000000000000000000000000
111111111111111111111100001111111111100000000
111111111111111111111111111111111111111111111
000000000003115255251111111112255655111111111
000000000026611526562665662662622522500000011
000000000555661125226626552635522552500000000
000000000622251125255623562566552555000000000
000000000665255112525226525662255650000000000
000000000556555211656655622566632200000000000
000000000026252261132665622252622220000000000
000000000002225231111141112252666626000000000
000000000002655611111323111166256230000000000
000000000062566211265525221111625556000000000
000000000555665211566656626211122600000000000
000000000562552511665622262561116600000000000
000000000525265611662256652656111100000000000
000000000565552112566265265522511111100000000
000000000265666112555666265525561111111111111
000000000626626442666635652566665500111111111
000000000562621136525652556625626250000111111
000000000662561155262252252566556322000000000
000000000052211622255525565566655662600000000
000000000011112222555523662225666622600000000
111111111112565665656623325526265252600000000
000000000022625656566256262255526622500000000
000000000056556652255565252562656522600000000
000000000005255236525252555666565223200000000
000000000055262255656252236552566626200000000
000000000553566662266625552635552636500000000
000000000065225325525266255225252525600000000
000000000006556555562000000026565520000000000
000000000000000000000000000000000000000000000
000000000000000000000000000000000000000000000
000000000000000000000000000000000000000000000
000000000000000000000000000000000000000000000
000000000000000000000000000000000000000000000
000000000000000000000000000000000000000000000
000000000000000000000000000000000000000000000
