000000000000000000000000000000000000000000000
000000000000000000000000000000000000000000000
000000000000000000000000000000000000000000000
000000000000000000000000000000000000000000000
000000000000000000000000000000000000000000000
000000000000000000000000000000000000000000000
000000000000000000000000000000000000000000000
000000000000000000000000000000000000000000000
111111111111111111111100001111111111100000000
111111111111111111111111111111111111111111111
000000000003115225521111111112225625111111111
000000000056211555655265626622522255200000011
000000000656651165266225562636565652500000000
000000000562221155552553256255556222000000000
000000000266662116552256522625525520000000000
000000000565252511222566565556632200000000000
000000000065255251132655665265622220000000000
000000000005525631111141116556666622000000000
000000000006665511111323111126256230000000000
000000000025556511565655621111625555000000000
000000000262266611266626222511165600000000000
000000000225656511525522656221116500000000000
000000000522662211666556525256111100000000000
000000000662566116662226655222611111100000000
000000000655562112555666226665521111111111111
000000000666622442665532256225522600111111111
000000000665621135526225655225525650000111111
000000000665621125266655656566225355000000000
000000000065511655255252266656662562600000000
000000000011116262225253552665222656200000000
111111111116256656566623322565255655600000000
000000000065265222622262652566552665200000000
000000000055252522525656555265566565200000000
000000000006522232526252662626666663600000000
000000000056525525526226532222225662600000000
000000000223655566625626566536652636600000000
000000000052266355222566226655626562200000000
000000000006652626652000000052522220000000000
000000000000000000000000000000000000000000000
000000000000000000000000000000000000000000000
000000000000000000000000000000000000000000000
000000000000000000000000000000000000000000000
000000000000000000000000000000000000000000000
000000000000000000000000000000000000000000000
000000000000000000000000000000000000000000000
