000000000000000000000000000000000000000000000
000000000000000000000000000000000000000000000
000000000000000000000000000000000000000000000
000000000000000000000000000000000000000000000
000000000000000000000000000000000000000000000
000000000000000000000000000000000000000000000
000000000000000000000000000000000000000000000
000000000000000000000000000000000000000000000
111111111111111111111100001111111111100000000
111111111111111111111111111111111111111111111
000000000003112655251111111112525255111111111
000000000022211565662652266226625626200000011
000000000652621126562552222532556662200000000
000000000265521156662623665566256256000000000
000000000666256116266622255655565650000000000
000000000226526211262255666622235500000000000
000000000055522661132222626652556560000000000
000000000002266631111141115526665256000000000
000000000005252211111353111156255530000000000
000000000062665211655222621111566222000000000
000000000252525511226666652211156600000000000
000000000266655611552662562261112500000000000
000000000256222511266252652552111100000000000
000000000226565115652566266266611111100000000
000000000525652112656622225655221111111111111
000000000662552442265632252255555600111111111
000000000652261136265655665565666220000111111
000000000265661152662266226625262356000000000
000000000056511652655252252565652622600000000
000000000011112652556663255665666256200000000
111111111112626555665553356665252262500000000
000000000066266655562225222525266262200000000
000000000022652222266566666255562655600000000
000000000005652632665566656525652663500000000
000000000025265525256262635622522252200000000
000000000623625262662665525232256636600000000
000000000026656362565526555665256252600000000
000000000006662556525000000062252260000000000
000000000000000000000000000000000000000000000
000000000000000000000000000000000000000000000
000000000000000000000000000000000000000000000
000000000000000000000000000000000000000000000
000000000000000000000000000000000000000000000
000000000000000000000000000000000000000000000
000000000000000000000000000000000000000000000
